,Año,Trimestre,Provincia,Banda ancha fija,Dial up,Total
0,2022,4,Buenos Aires,4788466,6199,4794665
1,2022,4,Capital Federal,1549781,2145,1551926
2,2022,4,Catamarca,70908,1,70909
3,2022,4,Chaco,143658,5,143663
4,2022,4,Chubut,167855,904,168759
5,2022,4,Córdoba,1049592,68,1049660
6,2022,4,Corrientes,155449,4,155453
7,2022,4,Entre Ríos,270952,22,270974
8,2022,4,Formosa,61840,0,61840
9,2022,4,Jujuy,118218,0,118218
10,2022,4,La Pampa,113993,171,114164
11,2022,4,La Rioja,86258,4,86262
12,2022,4,Mendoza,291327,777,292104
13,2022,4,Misiones,186269,0,186269
14,2022,4,Neuquén,159712,468,160180
15,2022,4,Río Negro,161544,548,162092
16,2022,4,Salta,205855,5,205860
17,2022,4,San Juan,103545,281,103826
18,2022,4,San Luis,135028,192,135220
19,2022,4,Santa Cruz,50005,198,50203
20,2022,4,Santa Fe,887581,110,887691
21,2022,4,Santiago Del Estero,119492,2,119494
22,2022,4,Tierra Del Fuego,54948,312,55260
23,2022,4,Tucumán,263392,30,263422
24,2022,3,Buenos Aires,4715469,6199,4721668
25,2022,3,Capital Federal,1545534,2145,1547679
26,2022,3,Catamarca,70292,1,70293
27,2022,3,Chaco,144141,5,144146
28,2022,3,Chubut,164874,904,165778
29,2022,3,Córdoba,1038600,68,1038668
30,2022,3,Corrientes,144842,4,144846
31,2022,3,Entre Ríos,268937,22,268959
32,2022,3,Formosa,68537,1,68538
33,2022,3,Jujuy,118823,0,118823
34,2022,3,La Pampa,115921,171,116092
35,2022,3,La Rioja,86860,4,86864
36,2022,3,Mendoza,288746,777,289523
37,2022,3,Misiones,182157,0,182157
38,2022,3,Neuquén,162693,468,163161
39,2022,3,Río Negro,160010,548,160558
40,2022,3,Salta,204536,5,204541
41,2022,3,San Juan,103118,281,103399
42,2022,3,San Luis,121888,182,122070
43,2022,3,Santa Cruz,49312,198,49510
44,2022,3,Santa Fe,887700,110,887810
45,2022,3,Santiago Del Estero,119030,2,119032
46,2022,3,Tierra Del Fuego,53584,312,53896
47,2022,3,Tucumán,263087,30,263117
48,2022,2,Buenos Aires,4660984,6199,4667183
49,2022,2,Capital Federal,1534626,2145,1536771
50,2022,2,Catamarca,67007,1,67008
51,2022,2,Chaco,143559,5,143564
52,2022,2,Chubut,161901,904,162805
53,2022,2,Córdoba,1026367,68,1026435
54,2022,2,Corrientes,144993,4,144997
55,2022,2,Entre Ríos,269330,22,269352
56,2022,2,Formosa,67881,0,67881
57,2022,2,Jujuy,115314,0,115314
58,2022,2,La Pampa,111356,171,111527
59,2022,2,La Rioja,86026,4,86030
60,2022,2,Mendoza,278785,777,279562
61,2022,2,Misiones,178813,0,178813
62,2022,2,Neuquén,161500,468,161968
63,2022,2,Río Negro,159216,548,159764
64,2022,2,Salta,203172,5,203177
65,2022,2,San Juan,100126,281,100407
66,2022,2,San Luis,121559,182,121741
67,2022,2,Santa Cruz,48987,198,49185
68,2022,2,Santa Fe,878749,110,878859
69,2022,2,Santiago Del Estero,118042,2,118044
70,2022,2,Tierra Del Fuego,53458,312,53770
71,2022,2,Tucumán,254497,30,254527
72,2022,1,Buenos Aires,4549131,6293,4555424
73,2022,1,Capital Federal,1415378,2163,1417541
74,2022,1,Catamarca,62377,1,62378
75,2022,1,Chaco,144114,5,144119
76,2022,1,Chubut,170701,927,171628
77,2022,1,Córdoba,1003729,74,1003803
78,2022,1,Corrientes,142574,4,142578
79,2022,1,Entre Ríos,267904,22,267926
80,2022,1,Formosa,54548,0,54548
81,2022,1,Jujuy,116509,0,116509
82,2022,1,La Pampa,109560,172,109732
83,2022,1,La Rioja,84299,4,84303
84,2022,1,Mendoza,274399,786,275185
85,2022,1,Misiones,171508,0,171508
86,2022,1,Neuquén,149208,471,149679
87,2022,1,Río Negro,156821,553,157374
88,2022,1,Salta,197510,5,197515
89,2022,1,San Juan,87888,290,88178
90,2022,1,San Luis,119659,185,119844
91,2022,1,Santa Cruz,48898,204,49102
92,2022,1,Santa Fe,870364,115,870479
93,2022,1,Santiago Del Estero,116459,2,116461
94,2022,1,Tierra Del Fuego,52298,313,52611
95,2022,1,Tucumán,245554,30,245584
96,2021,4,Buenos Aires,4502772,6385,4509157
97,2021,4,Capital Federal,1409935,2184,1412119
98,2021,4,Catamarca,59089,1,59090
99,2021,4,Chaco,143740,5,143745
100,2021,4,Chubut,159364,944,160308
101,2021,4,Córdoba,986693,77,986770
102,2021,4,Corrientes,135908,4,135912
103,2021,4,Entre Ríos,265024,22,265046
104,2021,4,Formosa,53663,0,53663
105,2021,4,Jujuy,113915,0,113915
106,2021,4,La Pampa,106834,173,107007
107,2021,4,La Rioja,83124,4,83128
108,2021,4,Mendoza,266783,804,267587
109,2021,4,Misiones,171132,0,171132
110,2021,4,Neuquén,146989,477,147466
111,2021,4,Río Negro,153189,564,153753
112,2021,4,Salta,199399,6,199405
113,2021,4,San Juan,79667,291,79958
114,2021,4,San Luis,118662,187,118849
115,2021,4,Santa Cruz,48276,210,48486
116,2021,4,Santa Fe,866265,176,866441
117,2021,4,Santiago Del Estero,115859,2,115861
118,2021,4,Tierra Del Fuego,52042,315,52357
119,2021,4,Tucumán,238609,30,238639
120,2021,3,Buenos Aires,4246425,5184,4251609
121,2021,3,Capital Federal,1411797,1608,1413405
122,2021,3,Catamarca,56253,1,56254
123,2021,3,Chaco,139868,3,139871
124,2021,3,Chubut,155266,800,156066
125,2021,3,Córdoba,946726,62,946788
126,2021,3,Corrientes,133816,3,133819
127,2021,3,Entre Ríos,260360,15,260375
128,2021,3,Formosa,52795,0,52795
129,2021,3,Jujuy,111158,0,111158
130,2021,3,La Pampa,100371,116,100487
131,2021,3,La Rioja,82157,3,82160
132,2021,3,Mendoza,255320,619,255939
133,2021,3,Misiones,158528,0,158528
134,2021,3,Neuquén,139436,373,139809
135,2021,3,Río Negro,144084,501,144585
136,2021,3,Salta,195831,2,195833
137,2021,3,San Juan,79227,256,79483
138,2021,3,San Luis,117716,148,117864
139,2021,3,Santa Cruz,48779,197,48976
140,2021,3,Santa Fe,841433,151,841584
141,2021,3,Santiago Del Estero,115457,1,115458
142,2021,3,Tierra Del Fuego,49934,289,50223
143,2021,3,Tucumán,232447,25,232472
144,2021,2,Buenos Aires,4127167,5184,4132351
145,2021,2,Capital Federal,1398747,1608,1400355
146,2021,2,Catamarca,55743,1,55744
147,2021,2,Chaco,140726,3,140729
148,2021,2,Chubut,138412,825,139237
149,2021,2,Córdoba,930818,62,930880
150,2021,2,Corrientes,129498,3,129501
151,2021,2,Entre Ríos,257617,15,257632
152,2021,2,Formosa,51551,0,51551
153,2021,2,Jujuy,111848,0,111848
154,2021,2,La Pampa,97551,116,97667
155,2021,2,La Rioja,81599,3,81602
156,2021,2,Mendoza,229052,619,229671
157,2021,2,Misiones,156176,0,156176
158,2021,2,Neuquén,137877,373,138250
159,2021,2,Río Negro,143583,501,144084
160,2021,2,Salta,191637,2,191639
161,2021,2,San Juan,78677,256,78933
162,2021,2,San Luis,122670,148,122818
163,2021,2,Santa Cruz,48785,197,48982
164,2021,2,Santa Fe,840449,151,840600
165,2021,2,Santiago Del Estero,114089,1,114090
166,2021,2,Tierra Del Fuego,35404,289,35693
167,2021,2,Tucumán,233026,25,233051
168,2021,1,Buenos Aires,4054936,5066,4060002
169,2021,1,Capital Federal,1378283,1390,1379673
170,2021,1,Catamarca,51967,1,51968
171,2021,1,Chaco,139767,3,139770
172,2021,1,Chubut,131515,825,132340
173,2021,1,Córdoba,910826,55,910881
174,2021,1,Corrientes,126622,3,126625
175,2021,1,Entre Ríos,251950,13,251963
176,2021,1,Formosa,50686,0,50686
177,2021,1,Jujuy,110456,0,110456
178,2021,1,La Pampa,96989,116,97105
179,2021,1,La Rioja,52625,3,52628
180,2021,1,Mendoza,218308,615,218923
181,2021,1,Misiones,149387,0,149387
182,2021,1,Neuquén,132862,373,133235
183,2021,1,Río Negro,140667,501,141168
184,2021,1,Salta,187572,2,187574
185,2021,1,San Juan,78011,256,78267
186,2021,1,San Luis,119006,148,119154
187,2021,1,Santa Cruz,45868,197,46065
188,2021,1,Santa Fe,825990,137,826127
189,2021,1,Santiago Del Estero,111640,1,111641
190,2021,1,Tierra Del Fuego,40133,289,40422
191,2021,1,Tucumán,231890,22,231912
192,2020,4,Buenos Aires,4028195,5066,4033261
193,2020,4,Capital Federal,1378140,1390,1379530
194,2020,4,Catamarca,52395,1,52396
195,2020,4,Chaco,139088,3,139091
196,2020,4,Chubut,129749,825,130574
197,2020,4,Córdoba,902646,55,902701
198,2020,4,Corrientes,125656,3,125659
199,2020,4,Entre Ríos,247368,13,247381
200,2020,4,Formosa,50206,0,50206
201,2020,4,Jujuy,105851,0,105851
202,2020,4,La Pampa,96779,116,96895
203,2020,4,La Rioja,52775,3,52778
204,2020,4,Mendoza,214838,615,215453
205,2020,4,Misiones,147161,0,147161
206,2020,4,Neuquén,132762,373,133135
207,2020,4,Río Negro,140709,501,141210
208,2020,4,Salta,187388,2,187390
209,2020,4,San Juan,72340,256,72596
210,2020,4,San Luis,119287,148,119435
211,2020,4,Santa Cruz,40477,197,40674
212,2020,4,Santa Fe,820676,137,820813
213,2020,4,Santiago Del Estero,106668,1,106669
214,2020,4,Tierra Del Fuego,39325,289,39614
215,2020,4,Tucumán,231067,22,231089
216,2020,3,Buenos Aires,3932211,5066,3937277
217,2020,3,Capital Federal,1371285,1390,1372675
218,2020,3,Catamarca,49903,1,49904
219,2020,3,Chaco,133951,3,133954
220,2020,3,Chubut,129202,825,130027
221,2020,3,Córdoba,867417,55,867472
222,2020,3,Corrientes,123388,3,123391
223,2020,3,Entre Ríos,241482,13,241495
224,2020,3,Formosa,49209,0,49209
225,2020,3,Jujuy,106728,0,106728
226,2020,3,La Pampa,93619,116,93735
227,2020,3,La Rioja,52613,3,52616
228,2020,3,Mendoza,207173,615,207788
229,2020,3,Misiones,143186,0,143186
230,2020,3,Neuquén,128862,373,129235
231,2020,3,Río Negro,130966,501,131467
232,2020,3,Salta,180844,2,180846
233,2020,3,San Juan,77071,256,77327
234,2020,3,San Luis,116417,148,116565
235,2020,3,Santa Cruz,39084,197,39281
236,2020,3,Santa Fe,802861,137,802998
237,2020,3,Santiago Del Estero,105491,1,105492
238,2020,3,Tierra Del Fuego,39366,289,39655
239,2020,3,Tucumán,223854,22,223876
240,2020,2,Buenos Aires,3772480,5066,3777546
241,2020,2,Capital Federal,1356431,1390,1357821
242,2020,2,Catamarca,47975,1,47976
243,2020,2,Chaco,128129,3,128132
244,2020,2,Chubut,107831,825,108656
245,2020,2,Córdoba,836413,55,836468
246,2020,2,Corrientes,118863,3,118866
247,2020,2,Entre Ríos,234100,13,234113
248,2020,2,Formosa,47932,0,47932
249,2020,2,Jujuy,94316,0,94316
250,2020,2,La Pampa,89693,116,89809
251,2020,2,La Rioja,52152,3,52155
252,2020,2,Mendoza,200569,615,201184
253,2020,2,Misiones,140340,0,140340
254,2020,2,Neuquén,125799,373,126172
255,2020,2,Río Negro,128985,501,129486
256,2020,2,Salta,177760,2,177762
257,2020,2,San Juan,69521,256,69777
258,2020,2,San Luis,113804,148,113952
259,2020,2,Santa Cruz,38672,197,38869
260,2020,2,Santa Fe,777795,137,777932
261,2020,2,Santiago Del Estero,105446,1,105447
262,2020,2,Tierra Del Fuego,38900,289,39189
263,2020,2,Tucumán,217134,22,217156
264,2020,1,Buenos Aires,3702985,5066,3708051
265,2020,1,Capital Federal,1352104,1390,1353494
266,2020,1,Catamarca,39634,1,39635
267,2020,1,Chaco,120274,3,120277
268,2020,1,Chubut,95938,800,96738
269,2020,1,Córdoba,811044,55,811099
270,2020,1,Corrientes,113967,3,113970
271,2020,1,Entre Ríos,231833,13,231846
272,2020,1,Formosa,46434,0,46434
273,2020,1,Jujuy,91665,0,91665
274,2020,1,La Pampa,89110,116,89226
275,2020,1,La Rioja,48337,3,48340
276,2020,1,Mendoza,182837,615,183452
277,2020,1,Misiones,133552,0,133552
278,2020,1,Neuquén,121354,373,121727
279,2020,1,Río Negro,125699,501,126200
280,2020,1,Salta,170379,2,170381
281,2020,1,San Juan,63975,256,64231
282,2020,1,San Luis,110404,148,110552
283,2020,1,Santa Cruz,38625,197,38822
284,2020,1,Santa Fe,770981,137,771118
285,2020,1,Santiago Del Estero,102754,1,102755
286,2020,1,Tierra Del Fuego,38505,289,38794
287,2020,1,Tucumán,200045,22,200067
288,2019,4,Buenos Aires,3681120,5134,3686254
289,2019,4,Capital Federal,1356695,1410,1358105
290,2019,4,Catamarca,38310,1,38311
291,2019,4,Chaco,117900,3,117903
292,2019,4,Chubut,95292,810,96102
293,2019,4,Córdoba,806633,55,806688
294,2019,4,Corrientes,113831,3,113834
295,2019,4,Entre Ríos,239017,13,239030
296,2019,4,Formosa,46711,0,46711
297,2019,4,Jujuy,88881,0,88881
298,2019,4,La Pampa,90280,119,90399
299,2019,4,La Rioja,48999,3,49002
300,2019,4,Mendoza,185157,623,185780
301,2019,4,Misiones,135813,0,135813
302,2019,4,Neuquén,116069,376,116445
303,2019,4,Río Negro,126636,504,127140
304,2019,4,Salta,172443,2,172445
305,2019,4,San Juan,64715,259,64974
306,2019,4,San Luis,108053,148,108201
307,2019,4,Santa Cruz,39170,200,39370
308,2019,4,Santa Fe,769019,150,769169
309,2019,4,Santiago Del Estero,103587,1,103588
310,2019,4,Tierra Del Fuego,40101,291,40392
311,2019,4,Tucumán,198621,23,198644
312,2019,3,Buenos Aires,3950114,10119,3960233
313,2019,3,Capital Federal,1437734,3477,1441211
314,2019,3,Catamarca,32391,9,32400
315,2019,3,Chaco,114438,13,114451
316,2019,3,Chubut,87481,1524,89005
317,2019,3,Córdoba,782946,107,783053
318,2019,3,Corrientes,112749,10,112759
319,2019,3,Entre Ríos,238057,45,238102
320,2019,3,Formosa,46066,0,46066
321,2019,3,Jujuy,86575,1,86576
322,2019,3,La Pampa,90559,269,90828
323,2019,3,La Rioja,49659,18,49677
324,2019,3,Mendoza,223015,1322,224337
325,2019,3,Misiones,133883,0,133883
326,2019,3,Neuquén,123435,1986,125421
327,2019,3,Río Negro,143391,904,144295
328,2019,3,Salta,151834,1,151835
329,2019,3,San Juan,72535,563,73098
330,2019,3,San Luis,122409,291,122700
331,2019,3,Santa Cruz,37642,328,37970
332,2019,3,Santa Fe,760706,228,760934
333,2019,3,Santiago Del Estero,133130,2,133132
334,2019,3,Tierra Del Fuego,48043,544,48587
335,2019,3,Tucumán,164099,32,164131
336,2019,2,Buenos Aires,3845594,10104,3855698
337,2019,2,Capital Federal,1412177,3443,1415620
338,2019,2,Catamarca,33626,9,33635
339,2019,2,Chaco,108721,13,108734
340,2019,2,Chubut,86038,1518,87556
341,2019,2,Córdoba,775023,105,775128
342,2019,2,Corrientes,111539,10,111549
343,2019,2,Entre Ríos,235780,44,235824
344,2019,2,Formosa,46438,0,46438
345,2019,2,Jujuy,86706,1,86707
346,2019,2,La Pampa,89937,268,90205
347,2019,2,La Rioja,50283,18,50301
348,2019,2,Mendoza,222535,1322,223857
349,2019,2,Misiones,132878,0,132878
350,2019,2,Neuquén,120954,1999,122953
351,2019,2,Río Negro,137632,915,138547
352,2019,2,Salta,142567,1,142568
353,2019,2,San Juan,69461,564,70025
354,2019,2,San Luis,117094,291,117385
355,2019,2,Santa Cruz,30225,325,30550
356,2019,2,Santa Fe,743258,226,743484
357,2019,2,Santiago Del Estero,126752,2,126754
358,2019,2,Tierra Del Fuego,46910,544,47454
359,2019,2,Tucumán,166299,32,166331
360,2019,1,Buenos Aires,3736563,10104,3746667
361,2019,1,Capital Federal,1396157,3443,1399600
362,2019,1,Catamarca,33613,9,33622
363,2019,1,Chaco,103664,13,103677
364,2019,1,Chubut,78260,1518,79778
365,2019,1,Córdoba,744010,105,744115
366,2019,1,Corrientes,102477,10,102487
367,2019,1,Entre Ríos,232403,44,232447
368,2019,1,Formosa,45211,0,45211
369,2019,1,Jujuy,90146,1,90147
370,2019,1,La Pampa,88892,268,89160
371,2019,1,La Rioja,51638,18,51656
372,2019,1,Mendoza,204976,1322,206298
373,2019,1,Misiones,122720,0,122720
374,2019,1,Neuquén,112321,2056,114377
375,2019,1,Río Negro,120173,915,121088
376,2019,1,Salta,136019,1,136020
377,2019,1,San Juan,61881,564,62445
378,2019,1,San Luis,96044,291,96335
379,2019,1,Santa Cruz,24580,325,24905
380,2019,1,Santa Fe,736851,227,737078
381,2019,1,Santiago Del Estero,89851,2,89853
382,2019,1,Tierra Del Fuego,45903,544,46447
383,2019,1,Tucumán,171970,32,172002
384,2018,4,Buenos Aires,3626502,10104,3636606
385,2018,4,Capital Federal,1385577,3443,1389020
386,2018,4,Catamarca,33574,9,33583
387,2018,4,Chaco,103257,13,103270
388,2018,4,Chubut,77204,1518,78722
389,2018,4,Córdoba,737234,105,737339
390,2018,4,Corrientes,100591,10,100601
391,2018,4,Entre Ríos,222003,44,222047
392,2018,4,Formosa,45204,0,45204
393,2018,4,Jujuy,90132,1,90133
394,2018,4,La Pampa,85368,268,85636
395,2018,4,La Rioja,51633,18,51651
396,2018,4,Mendoza,204982,1322,206304
397,2018,4,Misiones,116273,0,116273
398,2018,4,Neuquén,112309,2056,114365
399,2018,4,Río Negro,115922,915,116837
400,2018,4,Salta,134577,1,134578
401,2018,4,San Juan,61834,564,62398
402,2018,4,San Luis,96040,291,96331
403,2018,4,Santa Cruz,24443,325,24768
404,2018,4,Santa Fe,720161,229,720390
405,2018,4,Santiago Del Estero,89333,2,89335
406,2018,4,Tierra Del Fuego,45716,544,46260
407,2018,4,Tucumán,171972,32,172004
408,2018,3,Buenos Aires,3599714,10563,3610277
409,2018,3,Capital Federal,1385804,6686,1392490
410,2018,3,Catamarca,34215,11,34226
411,2018,3,Chaco,102021,12,102033
412,2018,3,Chubut,101310,2426,103736
413,2018,3,Córdoba,725764,94,725858
414,2018,3,Corrientes,99445,11,99456
415,2018,3,Entre Ríos,204560,48,204608
416,2018,3,Formosa,44865,0,44865
417,2018,3,Jujuy,44934,1,44935
418,2018,3,La Pampa,83180,244,83424
419,2018,3,La Rioja,51855,17,51872
420,2018,3,Mendoza,205545,1484,207029
421,2018,3,Misiones,108042,0,108042
422,2018,3,Neuquén,114713,2005,116718
423,2018,3,Río Negro,112433,1059,113492
424,2018,3,Salta,132882,1,132883
425,2018,3,San Juan,63823,658,64481
426,2018,3,San Luis,74121,300,74421
427,2018,3,Santa Cruz,33565,434,33999
428,2018,3,Santa Fe,694883,217,695100
429,2018,3,Santiago Del Estero,86358,2,86360
430,2018,3,Tierra Del Fuego,45056,508,45564
431,2018,3,Tucumán,171135,31,171166
432,2018,2,Buenos Aires,3490134,10565,3500699
433,2018,2,Capital Federal,1362498,6688,1369186
434,2018,2,Catamarca,34078,11,34089
435,2018,2,Chaco,98509,12,98521
436,2018,2,Chubut,98137,2427,100564
437,2018,2,Córdoba,712979,94,713073
438,2018,2,Corrientes,97946,11,97957
439,2018,2,Entre Ríos,199937,48,199985
440,2018,2,Formosa,44554,0,44554
441,2018,2,Jujuy,45132,1,45133
442,2018,2,La Pampa,82177,244,82421
443,2018,2,La Rioja,51931,17,51948
444,2018,2,Mendoza,199468,1484,200952
445,2018,2,Misiones,106147,0,106147
446,2018,2,Neuquén,113842,2006,115848
447,2018,2,Río Negro,111176,1059,112235
448,2018,2,Salta,134166,1,134167
449,2018,2,San Juan,63443,658,64101
450,2018,2,San Luis,21168,300,21468
451,2018,2,Santa Cruz,33970,435,34405
452,2018,2,Santa Fe,684243,309,684552
453,2018,2,Santiago Del Estero,83773,2,83775
454,2018,2,Tierra Del Fuego,44199,508,44707
455,2018,2,Tucumán,169926,31,169957
456,2018,1,Buenos Aires,3464882,10564,3475446
457,2018,1,Capital Federal,1359882,6688,1366570
458,2018,1,Catamarca,33934,11,33945
459,2018,1,Chaco,96925,12,96937
460,2018,1,Chubut,95532,2427,97959
461,2018,1,Córdoba,713825,101,713926
462,2018,1,Corrientes,94406,11,94417
463,2018,1,Entre Ríos,197346,48,197394
464,2018,1,Formosa,32328,0,32328
465,2018,1,Jujuy,44405,1,44406
466,2018,1,La Pampa,82668,396,83064
467,2018,1,La Rioja,52228,17,52245
468,2018,1,Mendoza,199463,1484,200947
469,2018,1,Misiones,103580,0,103580
470,2018,1,Neuquén,115897,2006,117903
471,2018,1,Río Negro,110057,1062,111119
472,2018,1,Salta,133182,1,133183
473,2018,1,San Juan,62610,658,63268
474,2018,1,San Luis,21096,300,21396
475,2018,1,Santa Cruz,33970,435,34405
476,2018,1,Santa Fe,679717,309,680026
477,2018,1,Santiago Del Estero,82916,2,82918
478,2018,1,Tierra Del Fuego,31106,508,31614
479,2018,1,Tucumán,168026,31,168057
480,2017,4,Buenos Aires,3171206,10690,3181896
481,2017,4,Capital Federal,1575418,6906,1582324
482,2017,4,Catamarca,29548,10,29558
483,2017,4,Chaco,96603,12,96615
484,2017,4,Chubut,91012,2428,93440
485,2017,4,Córdoba,709874,105,709979
486,2017,4,Corrientes,93760,11,93771
487,2017,4,Entre Ríos,193654,49,193703
488,2017,4,Formosa,32056,0,32056
489,2017,4,Jujuy,43551,1,43552
490,2017,4,La Pampa,81675,396,82071
491,2017,4,La Rioja,52177,17,52194
492,2017,4,Mendoza,178661,1490,180151
493,2017,4,Misiones,103895,0,103895
494,2017,4,Neuquén,114965,2006,116971
495,2017,4,Río Negro,108702,1062,109764
496,2017,4,Salta,132811,1,132812
497,2017,4,San Juan,57965,659,58624
498,2017,4,San Luis,14604,300,14904
499,2017,4,Santa Cruz,29018,434,29452
500,2017,4,Santa Fe,672137,323,672460
501,2017,4,Santiago Del Estero,68842,2,68844
502,2017,4,Tierra Del Fuego,28346,508,28854
503,2017,4,Tucumán,162298,34,162332
504,2017,3,Buenos Aires,3046758,11202,3057960
505,2017,3,Capital Federal,1563289,7070,1570359
506,2017,3,Catamarca,33467,11,33478
507,2017,3,Chaco,93747,12,93759
508,2017,3,Chubut,81067,2477,83544
509,2017,3,Córdoba,696536,108,696644
510,2017,3,Corrientes,92536,12,92548
511,2017,3,Entre Ríos,185414,50,185464
512,2017,3,Formosa,32105,0,32105
513,2017,3,Jujuy,43241,1,43242
514,2017,3,La Pampa,79280,410,79690
515,2017,3,La Rioja,51896,17,51913
516,2017,3,Mendoza,190958,1533,192491
517,2017,3,Misiones,100476,0,100476
518,2017,3,Neuquén,113755,2029,115784
519,2017,3,Río Negro,106393,1103,107496
520,2017,3,Salta,132517,1,132518
521,2017,3,San Juan,61789,660,62449
522,2017,3,San Luis,21408,311,21719
523,2017,3,Santa Cruz,33222,468,33690
524,2017,3,Santa Fe,662086,256,662342
525,2017,3,Santiago Del Estero,82792,2,82794
526,2017,3,Tierra Del Fuego,30883,583,31466
527,2017,3,Tucumán,160979,33,161012
528,2017,2,Buenos Aires,3067430,11201,3078631
529,2017,2,Capital Federal,1592175,8016,1600191
530,2017,2,Catamarca,26692,13,26705
531,2017,2,Chaco,90597,14,90611
532,2017,2,Chubut,62245,1730,63975
533,2017,2,Córdoba,657505,133,657638
534,2017,2,Corrientes,90085,12,90097
535,2017,2,Entre Ríos,182675,57,182732
536,2017,2,Formosa,29956,0,29956
537,2017,2,Jujuy,42656,1,42657
538,2017,2,La Pampa,72573,449,73022
539,2017,2,La Rioja,16271,18,16289
540,2017,2,Mendoza,169302,1451,170753
541,2017,2,Misiones,99794,0,99794
542,2017,2,Neuquén,115321,2112,117433
543,2017,2,Río Negro,100621,998,101619
544,2017,2,Salta,108540,1,108541
545,2017,2,San Juan,51261,620,51881
546,2017,2,San Luis,12992,315,13307
547,2017,2,Santa Cruz,26019,369,26388
548,2017,2,Santa Fe,566918,362,567280
549,2017,2,Santiago Del Estero,33194,2,33196
550,2017,2,Tierra Del Fuego,31938,619,32557
551,2017,2,Tucumán,154374,37,154411
552,2017,1,Buenos Aires,3178174,11202,3189376
553,2017,1,Capital Federal,1391030,8016,1399046
554,2017,1,Catamarca,26304,13,26317
555,2017,1,Chaco,89036,14,89050
556,2017,1,Chubut,62166,1730,63896
557,2017,1,Córdoba,641066,133,641199
558,2017,1,Corrientes,88596,12,88608
559,2017,1,Entre Ríos,180296,57,180353
560,2017,1,Formosa,29705,0,29705
561,2017,1,Jujuy,43202,1,43203
562,2017,1,La Pampa,71458,455,71913
563,2017,1,La Rioja,16207,18,16225
564,2017,1,Mendoza,169282,1451,170733
565,2017,1,Misiones,97619,0,97619
566,2017,1,Neuquén,113227,2112,115339
567,2017,1,Río Negro,100288,1000,101288
568,2017,1,Salta,107632,1,107633
569,2017,1,San Juan,51253,620,51873
570,2017,1,San Luis,12992,315,13307
571,2017,1,Santa Cruz,26116,370,26486
572,2017,1,Santa Fe,562520,362,562882
573,2017,1,Santiago Del Estero,34473,2,34475
574,2017,1,Tierra Del Fuego,31938,619,32557
575,2017,1,Tucumán,152734,37,152771
576,2016,4,Buenos Aires,3131499,11202,3142701
577,2016,4,Capital Federal,1393443,8016,1401459
578,2016,4,Catamarca,27021,13,27034
579,2016,4,Chaco,88833,14,88847
580,2016,4,Chubut,62035,1730,63765
581,2016,4,Córdoba,636422,133,636555
582,2016,4,Corrientes,88084,12,88096
583,2016,4,Entre Ríos,180188,57,180245
584,2016,4,Formosa,29513,0,29513
585,2016,4,Jujuy,42624,1,42625
586,2016,4,La Pampa,71368,460,71828
587,2016,4,La Rioja,16298,18,16316
588,2016,4,Mendoza,169274,1451,170725
589,2016,4,Misiones,97390,0,97390
590,2016,4,Neuquén,111723,2112,113835
591,2016,4,Río Negro,100020,1000,101020
592,2016,4,Salta,106934,1,106935
593,2016,4,San Juan,51301,620,51921
594,2016,4,San Luis,12992,315,13307
595,2016,4,Santa Cruz,26094,370,26464
596,2016,4,Santa Fe,561470,362,561832
597,2016,4,Santiago Del Estero,35049,2,35051
598,2016,4,Tierra Del Fuego,31938,619,32557
599,2016,4,Tucumán,151615,37,151652
600,2016,3,Buenos Aires,3075387,11205,3086592
601,2016,3,Capital Federal,1395053,8051,1403104
602,2016,3,Catamarca,26957,13,26970
603,2016,3,Chaco,89216,14,89230
604,2016,3,Chubut,62222,1730,63952
605,2016,3,Córdoba,642458,133,642591
606,2016,3,Corrientes,88328,12,88340
607,2016,3,Entre Ríos,181092,57,181149
608,2016,3,Formosa,27716,0,27716
609,2016,3,Jujuy,42537,1,42538
610,2016,3,La Pampa,69903,461,70364
611,2016,3,La Rioja,16912,18,16930
612,2016,3,Mendoza,169174,1450,170624
613,2016,3,Misiones,97997,0,97997
614,2016,3,Neuquén,110491,2112,112603
615,2016,3,Río Negro,100024,1002,101026
616,2016,3,Salta,107790,1,107791
617,2016,3,San Juan,51348,620,51968
618,2016,3,San Luis,12978,315,13293
619,2016,3,Santa Cruz,25886,371,26257
620,2016,3,Santa Fe,566625,386,567011
621,2016,3,Santiago Del Estero,35658,2,35660
622,2016,3,Tierra Del Fuego,31306,619,31925
623,2016,3,Tucumán,151282,37,151319
624,2016,2,Buenos Aires,3032776,12515,3045291
625,2016,2,Capital Federal,1384824,9760,1394584
626,2016,2,Catamarca,26543,13,26556
627,2016,2,Chaco,88235,16,88251
628,2016,2,Chubut,62116,1740,63856
629,2016,2,Córdoba,634680,234,634914
630,2016,2,Corrientes,86932,24,86956
631,2016,2,Entre Ríos,178194,179,178373
632,2016,2,Formosa,28801,1,28802
633,2016,2,Jujuy,41187,2,41189
634,2016,2,La Pampa,68403,485,68888
635,2016,2,La Rioja,16718,18,16736
636,2016,2,Mendoza,169274,1550,170824
637,2016,2,Misiones,95808,7,95815
638,2016,2,Neuquén,108224,2291,110515
639,2016,2,Río Negro,99631,1073,100704
640,2016,2,Salta,104929,3,104932
641,2016,2,San Juan,51392,621,52013
642,2016,2,San Luis,12939,317,13256
643,2016,2,Santa Cruz,25797,356,26153
644,2016,2,Santa Fe,563867,607,564474
645,2016,2,Santiago Del Estero,36958,3,36961
646,2016,2,Tierra Del Fuego,30740,619,31359
647,2016,2,Tucumán,148636,41,148677
648,2016,1,Buenos Aires,2929903,12612,2942515
649,2016,1,Capital Federal,1328079,9817,1337896
650,2016,1,Catamarca,26376,13,26389
651,2016,1,Chaco,86635,16,86651
652,2016,1,Chubut,62060,1740,63800
653,2016,1,Córdoba,609692,234,609926
654,2016,1,Corrientes,85510,26,85536
655,2016,1,Entre Ríos,174634,179,174813
656,2016,1,Formosa,28313,1,28314
657,2016,1,Jujuy,40287,2,40289
658,2016,1,La Pampa,65442,487,65929
659,2016,1,La Rioja,16673,18,16691
660,2016,1,Mendoza,169257,1553,170810
661,2016,1,Misiones,92951,7,92958
662,2016,1,Neuquén,101969,2292,104261
663,2016,1,Río Negro,98745,1077,99822
664,2016,1,Salta,102423,3,102426
665,2016,1,San Juan,51373,621,51994
666,2016,1,San Luis,12915,317,13232
667,2016,1,Santa Cruz,25931,356,26287
668,2016,1,Santa Fe,551378,618,551996
669,2016,1,Santiago Del Estero,37695,3,37698
670,2016,1,Tierra Del Fuego,29867,619,30486
671,2016,1,Tucumán,146596,41,146637
672,2015,4,Buenos Aires,2946743,12642,2959385
673,2015,4,Capital Federal,1360381,9845,1370226
674,2015,4,Catamarca,26459,13,26472
675,2015,4,Chaco,86537,16,86553
676,2015,4,Chubut,62279,1740,64019
677,2015,4,Córdoba,625835,235,626070
678,2015,4,Corrientes,85409,26,85435
679,2015,4,Entre Ríos,173957,180,174137
680,2015,4,Formosa,28088,1,28089
681,2015,4,Jujuy,39922,2,39924
682,2015,4,La Pampa,66054,312,66366
683,2015,4,La Rioja,16914,18,16932
684,2015,4,Mendoza,169251,1556,170807
685,2015,4,Misiones,92846,7,92853
686,2015,4,Neuquén,105122,2294,107416
687,2015,4,Río Negro,98655,1067,99722
688,2015,4,Salta,101917,3,101920
689,2015,4,San Juan,51408,621,52029
690,2015,4,San Luis,12901,317,13218
691,2015,4,Santa Cruz,26047,356,26403
692,2015,4,Santa Fe,561045,627,561672
693,2015,4,Santiago Del Estero,39132,3,39135
694,2015,4,Tierra Del Fuego,29334,619,29953
695,2015,4,Tucumán,146053,42,146095
696,2015,3,Buenos Aires,2916070,12695,2928765
697,2015,3,Capital Federal,1362193,9875,1372068
698,2015,3,Catamarca,26080,13,26093
699,2015,3,Chaco,85354,16,85370
700,2015,3,Chubut,62143,1740,63883
701,2015,3,Córdoba,622761,237,622998
702,2015,3,Corrientes,84931,28,84959
703,2015,3,Entre Ríos,172252,182,172434
704,2015,3,Formosa,27751,1,27752
705,2015,3,Jujuy,39548,2,39550
706,2015,3,La Pampa,64976,495,65471
707,2015,3,La Rioja,16753,18,16771
708,2015,3,Mendoza,169261,1562,170823
709,2015,3,Misiones,91615,7,91622
710,2015,3,Neuquén,98376,2240,100616
711,2015,3,Río Negro,98529,1085,99614
712,2015,3,Salta,100570,3,100573
713,2015,3,San Juan,51409,621,52030
714,2015,3,San Luis,12902,317,13219
715,2015,3,Santa Cruz,25912,359,26271
716,2015,3,Santa Fe,556097,641,556738
717,2015,3,Santiago Del Estero,39394,3,39397
718,2015,3,Tierra Del Fuego,33118,619,33737
719,2015,3,Tucumán,144272,42,144314
720,2015,2,Buenos Aires,2871079,12711,2883790
721,2015,2,Capital Federal,1336391,9893,1346284
722,2015,2,Catamarca,25666,13,25679
723,2015,2,Chaco,83832,16,83848
724,2015,2,Chubut,61745,1740,63485
725,2015,2,Córdoba,609510,236,609746
726,2015,2,Corrientes,83288,28,83316
727,2015,2,Entre Ríos,169309,183,169492
728,2015,2,Formosa,27013,37,27050
729,2015,2,Jujuy,37720,2,37722
730,2015,2,La Pampa,63552,500,64052
731,2015,2,La Rioja,16491,18,16509
732,2015,2,Mendoza,169259,1564,170823
733,2015,2,Misiones,88512,7,88519
734,2015,2,Neuquén,95644,2241,97885
735,2015,2,Río Negro,97640,1087,98727
736,2015,2,Salta,98264,3,98267
737,2015,2,San Juan,51367,621,51988
738,2015,2,San Luis,12904,317,13221
739,2015,2,Santa Cruz,25384,379,25763
740,2015,2,Santa Fe,545739,649,546388
741,2015,2,Santiago Del Estero,39375,3,39378
742,2015,2,Tierra Del Fuego,32960,619,33579
743,2015,2,Tucumán,140635,42,140677
744,2015,1,Buenos Aires,2847076,14766,2861842
745,2015,1,Capital Federal,1321139,11582,1332721
746,2015,1,Catamarca,25312,20,25332
747,2015,1,Chaco,81329,31,81360
748,2015,1,Chubut,63327,1946,65273
749,2015,1,Córdoba,596663,294,596957
750,2015,1,Corrientes,81488,43,81531
751,2015,1,Entre Ríos,165839,231,166070
752,2015,1,Formosa,26657,43,26700
753,2015,1,Jujuy,36608,3,36611
754,2015,1,La Pampa,62155,542,62697
755,2015,1,La Rioja,16310,23,16333
756,2015,1,Mendoza,168355,1805,170160
757,2015,1,Misiones,85139,7,85146
758,2015,1,Neuquén,93373,2369,95742
759,2015,1,Río Negro,96145,1188,97333
760,2015,1,Salta,96793,18,96811
761,2015,1,San Juan,51117,702,51819
762,2015,1,San Luis,12878,354,13232
763,2015,1,Santa Cruz,26217,424,26641
764,2015,1,Santa Fe,535640,797,536437
765,2015,1,Santiago Del Estero,39244,8,39252
766,2015,1,Tierra Del Fuego,32726,730,33456
767,2015,1,Tucumán,138184,92,138276
768,2014,4,Buenos Aires,2801178,15229,2816407
769,2014,4,Capital Federal,1318526,11994,1330520
770,2014,4,Catamarca,25472,21,25493
771,2014,4,Chaco,65998,37,66035
772,2014,4,Chubut,66557,1985,68542
773,2014,4,Córdoba,590113,319,590432
774,2014,4,Corrientes,65656,54,65710
775,2014,4,Entre Ríos,140567,246,140813
776,2014,4,Formosa,26156,51,26207
777,2014,4,Jujuy,35999,3,36002
778,2014,4,La Pampa,56813,567,57380
779,2014,4,La Rioja,16379,23,16402
780,2014,4,Mendoza,167766,1848,169614
781,2014,4,Misiones,77222,7,77229
782,2014,4,Neuquén,92999,2397,95396
783,2014,4,Río Negro,95050,1210,96260
784,2014,4,Salta,93921,26,93947
785,2014,4,San Juan,51390,729,52119
786,2014,4,San Luis,12788,359,13147
787,2014,4,Santa Cruz,25277,436,25713
788,2014,4,Santa Fe,528459,938,529397
789,2014,4,Santiago Del Estero,39308,9,39317
790,2014,4,Tierra Del Fuego,28249,741,28990
791,2014,4,Tucumán,137329,95,137424
792,2014,3,Buenos Aires,2835537,14028,2849565
793,2014,3,Capital Federal,1307195,10630,1317825
794,2014,3,Catamarca,24665,21,24686
795,2014,3,Chaco,63710,36,63746
796,2014,3,Chubut,67130,2007,69137
797,2014,3,Córdoba,585231,200,585431
798,2014,3,Corrientes,63516,33,63549
799,2014,3,Entre Ríos,136618,115,136733
800,2014,3,Formosa,25873,64,25937
801,2014,3,Jujuy,33739,2,33741
802,2014,3,La Pampa,61861,564,62425
803,2014,3,La Rioja,15893,23,15916
804,2014,3,Mendoza,166184,1740,167924
805,2014,3,Misiones,75327,0,75327
806,2014,3,Neuquén,100099,2268,102367
807,2014,3,Río Negro,96629,1151,97780
808,2014,3,Salta,92929,25,92954
809,2014,3,San Juan,51031,748,51779
810,2014,3,San Luis,12683,363,13046
811,2014,3,Santa Cruz,25664,446,26110
812,2014,3,Santa Fe,520196,691,520887
813,2014,3,Santiago Del Estero,37539,9,37548
814,2014,3,Tierra Del Fuego,28037,755,28792
815,2014,3,Tucumán,131978,88,132066
816,2014,2,Buenos Aires,2750430,14116,2764546
817,2014,2,Capital Federal,1299502,10713,1310215
818,2014,2,Catamarca,24660,23,24683
819,2014,2,Chaco,63243,36,63279
820,2014,2,Chubut,68503,2016,70519
821,2014,2,Córdoba,576747,205,576952
822,2014,2,Corrientes,62925,33,62958
823,2014,2,Entre Ríos,135468,115,135583
824,2014,2,Formosa,25535,65,25600
825,2014,2,Jujuy,34359,2,34361
826,2014,2,La Pampa,55048,580,55628
827,2014,2,La Rioja,15889,23,15912
828,2014,2,Mendoza,165046,1761,166807
829,2014,2,Misiones,74689,0,74689
830,2014,2,Neuquén,90053,2235,92288
831,2014,2,Río Negro,94812,1145,95957
832,2014,2,Salta,91949,25,91974
833,2014,2,San Juan,50891,755,51646
834,2014,2,San Luis,12691,364,13055
835,2014,2,Santa Cruz,26710,459,27169
836,2014,2,Santa Fe,511753,605,512358
837,2014,2,Santiago Del Estero,38002,9,38011
838,2014,2,Tierra Del Fuego,27443,766,28209
839,2014,2,Tucumán,131981,88,132069
840,2014,1,Buenos Aires,2725732,14144,2739876
841,2014,1,Capital Federal,1289204,10714,1299918
842,2014,1,Catamarca,24209,23,24232
843,2014,1,Chaco,62520,36,62556
844,2014,1,Chubut,68205,2016,70221
845,2014,1,Córdoba,566705,205,566910
846,2014,1,Corrientes,62203,33,62236
847,2014,1,Entre Ríos,134216,115,134331
848,2014,1,Formosa,25335,87,25422
849,2014,1,Jujuy,33825,2,33827
850,2014,1,La Pampa,53601,592,54193
851,2014,1,La Rioja,15688,23,15711
852,2014,1,Mendoza,164084,1761,165845
853,2014,1,Misiones,73950,0,73950
854,2014,1,Neuquén,88077,2303,90380
855,2014,1,Río Negro,93909,1157,95066
856,2014,1,Salta,91265,25,91290
857,2014,1,San Juan,50543,755,51298
858,2014,1,San Luis,12193,364,12557
859,2014,1,Santa Cruz,26304,460,26764
860,2014,1,Santa Fe,506000,612,506612
861,2014,1,Santiago Del Estero,37124,9,37133
862,2014,1,Tierra Del Fuego,27272,766,28038
863,2014,1,Tucumán,129944,88,130032
